1111111111111
1P10000000001
101000100C001
1011011111111
1010001000101
1000001010001
1011101011111
100010001E001
1010101111001
1C10000000001
10111110C0001
100C000000001
1111111111111
