1111111111111
1001000000CC1
1000011111001
100011E000001
1111111111111